NO ./path_to_the_north_texture

EA ./path_to_the_east_texture
SO ./path_to_the_south_texture
WE ./path_to_the_west_texture

F 255,100,0
C 255,30,0

        1111111111111111111111111
        1000000000110000000000001 1
        10110000011100000000000011
        10010000000000000000000000111
11111111101100000111000000000000110001
10000000001100000111011111111111111111111
11110111111111011100000010001        10101
11110111111111011101010010001     1  100111111    11111
1100000011010101110000001001011111011011            101
100000000000000011000000101 10000000001             111
100000000000000011000000101 10011111111       
10000000000000001101010010010001
11000001110101011111011110N0111
11110111 1110101 10111101000001
11111111 1111111 1111111111111
