NO ./assets/dirt.xpm
SO ./assets/sand.xpm
WE ./assets/stone-block.xpm
EA ./assets/wood.xpm

F 255,100,0
C 10,125,255

        1111111111111111111111111
        1000000000110000000000001 1
        10110000011100000000000011
        10010000000000000000000000111
11111111101100000111000000000000110001
10000000001100000111011111111111111111111
11110111111111011100000010001        10101
11110111111111011101010000001     1  100111111    11111
1100000011010101110000001001011111011011            101
100000000000000000000000101 10000000001             111
100000000000000000000000001 10011111111       
10000000000000001101010010010001
11000001110101011111011110N0111
11110111 1110101 10111101000001
11111111 1111111 1111111111111
101
1101
1111 1111111111111111111111111111
11
11
1
1
1