NO ./assets/dirt.xpm
SO ./assets/sand.xpm
   WE ./assets/stone-block.xpm
EA ./assets/wood.xpm

  F  20,100,0
C 10,125,255

    1111111    
111110000011111
100000000000001
100000000011111
100000000000001
10000E000000001
111111111111111