NO ./assets/dirt.xpm
SO ./assets/sand.xpm
   WE ./assets/stone-block.xpm
EA ./assets/wood.xpm

  F  20,100,0
C 10,125,255

1
1
1
1
    1111111
11111N1000111111
10001110000000001111111111111111111111111111111
100000001111111111110001111111111111
100000000000001111111111111
10000000000001111111
1111111111111111101
11111111111111111111
111111111111111
111
1101
111