NO ./assets/barrel.xpm
SO ./assets/book.xpm
   WE ./assets/honey.xpm
EA ./assets/craft.xpm

F  175,143,85
C 10,125,255

    1111111    
111110000011111
100000000000001
10000000001111111111111111111111111111111111111111111111111111
10000000000000000000000000000000000000000000000000000000000001
10000E00000000000000000000000000000000000000000000000000000001
11111111111111111111111111111111111111111111111111111111111111
