NO ./assets/barrel.xpm
SO ./assets/book.xpm
   WE ./assets/honey.xpm
EA ./assets/craft.xpm

F  175,143,85
C 10,125,255

    1111111    
111110000011111
100000000000001
100001000000000111111111111111111111111111111111111111111111111
1000100000100000000000000000000000000000000000000000000000000001
10000E0000010000000000000000000000000000000000000000000000000001
1111111111111111111111111111111111111111111111111111111111111111
