NO ./path_to_the_north_texture
SO ./path_to_the_south_texture
WE ./path_to_the_west_texture
EA ./path_to_the_east_texture
F 220,100,0
C 255,30,0

    1111111    
111110000011111
100000N00000001
100000000111111
10000N000000001
100000000000001
111111111111111

