NO ./assets/barrel.xpm
SO ./assets/book.xpm
   WE ./assets/honey.xpm
EA ./assets/craft.xpm

F  175,143,85
C 10,125,255

    1111111    
1111100000111111
1000000000000001
1000010000000001111111111111111111111111111111111111111111111111
1000110000100000000000000000000000000000000000000000000000000001
100001E000001000000000000000000000000000000000000000000000000001
1111111111111111111111111111111111111111111111111111111111111111
