NO ./path_to_the_north_texture
SO ./path_to_the_south_texture
WE ./path_to_the_west_texture
EA ./path_to_the_east_texture
F 220,100,0
C 255,30,0

1111111111111111111
1000000000000000001
1000000000000000001
1000000000000000001
1000000000000000001
10001N1000000000001
1000000000000000001
1000000000000000001
1000000000000000001
1000000000000000001
1111111111111111111