NO ./assets/dirt.xpm
SO ./assets/sand.xpm
   WE ./assets/stone-block.xpm
EA ./assets/wood.xpm

  F  20,100,0
C 10,125,255

    1111111    
111110000011111
100000000000001
100E0000001111111
10000000000111101
1000000000000011
111111111111111
101
11