NO ./path_to_the_north_texture
SO ./path_to_the_south_texture
WE ./path_to_the_west_texture
EA ./path_to_the_east_texture
F 220,100,0
C 255,30,0

        111111111111111111111111
        1000000000110000000000001
        10110N00111000000001111111111
        10010000000000000001000000111
11111111101100000111000000000000110001
1000000000110000011101111111111111111111
11110111111111011100000010001       1001
11110111111111011101010010001       1001
110000001101010111000000100101111111101
100000000000000011000000101 10000000001
100000000000000011000000101 10011111111
1000000000000000110101001001001
1100000111010101111101111000111
11110111 1110101 10111101000001
11111111 1111111 1111111111111
