NO textures/north.xpm
SO textures/south.xpm
WE textures/west.xpm
EA textures/east.xpm

F 0,0,214
C 2,0,3

F 0,0,21





1111111111111111111111111             111111111111
1000000000110000000000001               11111111011111
1011000001110000000000001                    111111
10010000000000000000000011111111
111111111011000001110000000000001
1000000000110000011101111111111111111111111111111111111111111111111111111
11110111111111011100000010001
11110111111111011101010010001
110000001101010111000000100011111111111111111111111111111111111111111111111111
10000N00000000001100000010001
10000000000000001101010010001
111111111111111111111111111111
1100000111010101111101111000111          
11110111 1110101 101111010001
11111111 1111111 111111111111